,,,,,,,,,.,,,,,,,,,,
,;;,,,,,,.,#,,,,~~~,
,;,,,,,,,.,;;,O,~+~,
,;,,,,,,,.,;#,,~++~,
,,,,,,,,,.,;;#,~++~,
,,,,,,;,,.,#;,,~~~~,
,,,,,,;;,.,,,,#,,,,,
,,,,,,;;,...........
,#,,,,,,,,,,,,,,,,,,
,,,;;,,,,,,,,;;;;;,,
,,,;#;;,,O,,,,,,;;,,
,,,;;;;,,,,,,,,,,,,,
,,#;;;;#,,,,,,,,,,,,
,,,,,,,,,,,,,,,,,,,,
,,,,,,,,,,,,,,,,,,,,